1111111111111111111111
1110001000C00000000001
1000011110000000100001
11000000C0111111111111
1ECP1111000000000000C1
1111111111111111111111